10 14
|------------|
|F..|..P....@|
|P..-....F...|
|FF....|..|..|
|-.F...|..F..|
|P.F-..P.-...|
|..F...|..F..|
|.|...F......|
|.PF-..|..P|.|
|------------|